1111111111111111111
1P011C00001C11E00B1
1001100010001110001
10000CC001B00000001
100C000010011110111
1111111111111111111